W	W	W	W	W	W	W	W	W	W	W	W	W	W	W	W	W	W	W	W	W	W	W	W	W	W	W	W	W	W	W	W	W	W	W	W	W
W	F	F	F	F	F	F	F	W	F	W	F	W	F	F	F	F	F	F	F	F	F	F	F	W	F	F	F	W	F	F	F	F	F	W	F	W
W	F	W	W	W	W	W	W	W	F	W	F	W	W	W	F	W	F	W	W	W	F	W	W	W	F	W	W	W	W	W	W	W	F	W	F	W
W	F	F	F	F	F	F	F	W	F	F	F	F	F	F	F	W	F	W	F	F	F	F	F	W	F	F	F	F	F	W	F	W	F	F	F	W
W	W	W	W	W	F	W	W	W	W	W	F	W	W	W	F	W	F	W	F	W	F	W	W	W	F	W	W	W	W	W	F	W	F	W	W	W
W	F	F	F	W	F	W	F	W	F	W	F	F	F	W	F	W	F	W	F	W	F	F	F	W	F	W	F	F	F	W	F	W	F	F	F	W
W	F	W	W	W	F	W	F	W	F	W	F	W	W	W	F	W	W	W	W	W	F	W	W	W	F	W	F	W	W	W	F	W	W	W	F	W
W	F	F	F	F	F	F	F	W	F	F	F	F	F	W	F	F	F	W	F	F	F	W	F	F	F	F	F	W	F	W	F	W	F	F	F	W
W	W	W	F	W	W	W	W	W	W	W	W	W	F	W	W	W	W	W	W	W	F	W	W	W	F	W	W	W	F	W	F	W	F	W	F	W
W	F	F	F	F	F	F	F	F	F	F	F	F	F	W	F	F	F	F	F	F	F	W	F	W	F	F	F	W	F	F	F	F	F	W	F	W
W	F	W	F	W	W	W	W	W	F	W	F	W	W	W	F	W	F	W	F	W	W	W	F	W	F	W	W	W	F	W	W	W	F	W	F	W
W	F	W	F	W	F	F	F	F	F	W	F	W	F	W	F	W	F	W	F	F	F	F	F	W	F	F	F	W	F	W	F	W	F	W	F	W
W	F	W	F	W	F	W	W	W	W	W	W	W	F	W	F	W	W	W	W	W	W	W	W	W	F	W	W	W	F	W	F	W	W	W	F	W
W	F	W	F	W	F	W	F	F	F	F	F	W	F	F	F	W	F	F	F	F	F	W	F	F	F	F	F	W	F	F	F	W	F	F	F	W
W	W	W	F	W	W	W	F	W	F	W	W	W	W	W	F	W	W	W	W	W	F	W	W	W	F	W	W	W	F	W	W	W	W	W	F	W
W	F	F	F	F	F	W	F	W	F	W	F	F	F	F	F	W	F	W	F	F	F	F	F	W	F	W	F	F	F	W	F	W	F	W	F	W
W	F	W	F	W	F	W	F	W	F	W	W	W	F	W	W	W	F	W	W	W	F	W	W	W	F	W	F	W	F	W	F	W	F	W	F	W
W	F	W	F	W	F	W	F	W	F	F	F	F	F	F	F	F	F	F	F	F	F	F	F	F	F	W	F	W	F	W	F	F	F	F	F	W
W	W	W	F	W	W	W	W	W	W	W	F	W	F	W	F	W	W	W	W	W	F	W	W	W	F	W	F	W	W	W	F	W	W	W	W	W
W	F	F	F	F	F	F	F	W	F	W	F	W	F	W	F	F	F	F	F	W	F	F	F	W	F	F	F	F	F	W	F	W	F	F	F	W
W	W	W	W	W	F	W	F	W	F	W	W	W	W	W	W	W	W	W	F	W	W	W	W	W	W	W	W	W	W	W	F	W	F	W	W	W
W	F	F	F	W	F	W	F	F	F	F	F	F	F	F	F	F	F	W	F	W	F	F	F	F	F	W	F	F	F	W	F	W	F	F	F	W
W	F	W	W	W	F	W	W	W	W	W	F	W	W	W	W	W	W	W	W	W	F	W	W	W	W	W	F	W	F	W	F	W	W	W	F	W
W	F	W	F	F	F	W	F	F	F	F	F	F	W	F	F	F	F	F	F	F	F	W	F	F	F	F	F	W	F	F	F	F	F	F	F	W
W	F	W	F	W	F	W	W	W	W	W	F	W	W	W	F	W	F	W	F	W	F	W	F	W	W	W	W	W	W	W	W	W	W	W	W	W
W	F	W	F	W	F	F	F	W	F	F	F	F	F	W	F	W	F	W	F	W	F	F	F	F	F	F	F	W	F	F	F	W	F	W	F	W
W	F	W	F	W	W	W	F	W	W	W	F	W	F	W	F	W	F	W	W	W	W	W	W	W	W	W	F	W	W	W	F	W	F	W	F	W
W	F	W	F	F	F	W	F	W	F	F	F	W	F	W	F	W	F	F	F	W	F	W	F	F	F	W	F	W	F	W	F	F	F	F	F	W
W	F	W	W	W	F	W	W	W	F	W	W	W	W	W	F	W	W	W	F	W	F	W	F	W	W	W	W	W	F	W	F	W	W	W	W	W
W	F	F	F	F	F	F	F	W	F	F	F	W	F	F	F	F	F	W	F	W	F	F	F	F	F	W	F	F	F	W	F	W	F	F	F	W
W	W	W	F	W	F	W	W	W	W	W	F	W	W	W	W	W	F	W	W	W	F	W	W	W	F	W	F	W	W	W	F	W	F	W	W	W
W	F	W	F	W	F	W	F	W	F	W	F	W	F	W	F	F	F	F	F	W	F	W	F	F	F	W	F	W	F	F	F	W	F	W	F	W
W	F	W	F	W	W	W	F	W	F	W	F	W	F	W	F	W	W	W	W	W	W	W	W	W	F	W	F	W	F	W	F	W	F	W	F	W
W	F	F	F	W	F	F	F	W	F	F	F	W	F	F	F	F	F	F	F	F	F	F	F	F	F	F	F	F	F	W	F	F	F	F	F	W
W	F	W	F	W	F	W	F	W	W	W	F	W	W	W	F	W	W	W	W	W	W	W	F	W	W	W	F	W	W	W	F	W	W	W	F	W
D	F	F	W	F	W	F	F	F	F	F	F	F	W	F	F	F	W	F	F	F	F	F	F	F	W	F	F	F	W	F	W	F	F	F	P	W
W	W	W	W	W	W	W	W	W	W	W	W	W	W	W	W	W	W	W	W	W	W	W	W	W	W	W	W	W	W	W	W	W	W	W	W	W