W	W	W	W	W	W	W
W	P	F	F	W	F	W
W	W	W	F	W	F	W
W	W	F	F	W	W	W
W	F	W	F	W	F	W
W	W	F	F	F	F	W
W	W	W	W	W	F	W
W	F	F	W	W	F	D
W	W	W	W	W	W	W
